{
  "texture":"data/textures/tileset.png",
  "tileSize":32,
  "width":11,
  "height":5,
  "tiles":[
    0,0,0,0,25,0,0,0,0,0,25,
    0,0,0,0,29,0,0,0,0,0,29,
    0,0,0,0,34,40,0,26,40,0,29,
    0,0,0,0,0,0,0,29,0,0,29,
    38,39,39,39,39,39,39,35,39,39,36
  ]
}
